level0
000000000000000
000000000000000
111111110000000
222111100001110
222333000011100
000011022203300